экспансия: экспансии экспансия
чупров: чупрова чупров
скупать: скупали
подход: подходы подходов подходами подход подхода
год: год года годы годом годов году гг годах лет
marenzhi: marenzhi
оглавление: оглавлению оглавление оглавления
принять: приняли
a: a
туалетный: туалетной туалетную
этнический: этническую этнические
отдельный: отдельное отдельные отдельный отдельной отдельных отдельными отдельного
модель: моделей модели моделью
стать: стало стал статей ставшие стала стать стали ставшая станет
магнат: магнатах
европа: европе европы
никак: никак
хороший: лучше хорошее лучшие хороших хорошей хорошим хороший хорошая хороша наилучший хорошую хорошего лучшем
выходить: выходят выходил выходит
изречение: изречений
обстоять: обстоит обстоят
предложение: предложения предложение
пойти: пошёл пошло пойду пойдет пойдёт пошла
интересный: интересным интереснее интересные интересными интересна интересная интересную интересней интересных интереснейший интересного интересный
пустота: пустоте
готовиться: готовятся готовился готовьтесь
положение: положение положений положения положении положением
друг: друзья друг друга друзей
сс: сс
расстраивать: расстраивает
сосед: соседей
связь: связей связи
совмещать: совмещать
учебник: учебников учебник учебника учебником
автореферат: автореферат
нынешний: нынешней нынешних
небо: небо неба
формирование: формировании формированиях формирования формирование
скатиться: скатившейся
конгресс: конгресса
изгнание: изгнании
облипочка: облипочку
бумажный: бумажных
авантюристический: авантюристических авантюристическая
самостоятельно: самостоятельно
предисловие: предисловие предисловии
комфортно: комфортно
плакат: плакат
мудрый: мудрых
глава: главах главе глава
венгерский: венгерского венгерских
собрать: собрано собраны собрал
шарик: шарик шариков
талый: талую
занятие: занятиях занятия занятию занятий
основный: основная основным основное основного основных
раздатчица: раздатчицы
москва—: москва—
переходить: переходим
внятный: внятный
анализ: анализу анализ анализом анализа
вуз: вузов
бешенцев: бешенцева бешенцев
камбоджа: камбоджа
поиск: поиску поиска поиском
любимый: любимое любимый любимых любимого любимые любимой
штейн: штейн
чёрный: черным черная черный черные
победа: победа побед
значительно: значительно
содержать: содержит содержать
конкретный: конкретное конкретные конкретных
контроль: контроль контроля
полотно: полотно
создаваться: создается
методический: методические методического методическом
теория: теорий теорию теория теории
встреча: встречах
один: одной один одним одного одна одну одно
обосновываться: обосновываются обосновывается
„международный: „международные
заплатить: заплачен
сейчас: сейчас щас
придать: придали
существовать: существует существуют существовать существовали
сельский: сельское
круглый: круглый круглого круглом
идти: идти шла идущие идёт шел
страна: страну страной страны страна странах стран стране
труд: труд трудом труда трудов труды
крупный: крупным крупных крупном крупные крупнейших крупнейшие крупными
древний: древняя древних древней
первый: первом первую первая первой первому первый первым первого первые первых первое
существенный: существенной существенные
общеевропейский: общеевропейский
реализация: реализации реализация
xviii: xviii
научный: научные научную научной научного научная научном научный научное научных
эратосфен: эратосфен
немногие: немногие
изложение: изложение изложении
представить: представлена представить представлены представлен представленные
основоположник: основоположник
выпустить: выпущенная выпущенных выпущенной выпустим
себя: себя собой себе
взгляд: взглядах взгляде взглядов взгляд взглядам взгляды
старость: старости
назвать: назвать названа
детвора: детвора
внутренний: внутреннем внутреннего внутренний внутренней
пекин: пекин
серый: сером серый серого
сыр: сыром
подвигать: подвигало
перегородить: перегороженный
замечание: замечания
ссср: ссср
выторговать: выторговал
объединение: объединений объединением
путь: путь путям путей пути
попасть: попала
она: она ей ней нее ее неё
разбор: разбору разборе разбора
перестройка: перестройки перестройку
сильный: сильные
семейство: семейства
ога: ога
родственник: родственников
срок: срока
забор: забором забор заборами заборах забора
институт: института институт институтом институте институтов
общество: общество обществе общества
цэй: цэми
помощь: помощью помощи помощь
полный: полное полного полнейший полной полный
кто-нибудь: кто-нибудь
управленческий: управленческой управленческих управленческая
сам: сами сам самом сама самих само самой самого
трубка: трубкой
тип: типа
факультет: факультетов факультете
новый: новых новая новые нового новой новую новом новое новейших новый
инженерно-экономический: инженерно-экономической
орден: ордена
марксистский: марксистским марксистское
иностранный: иностранным иностранной иностранных
архив: архива архивах архивы архив
тротуар: тротуар
мышьяк: мышьяка
полезность: полезность полезностей полезности
помогать: помогал помогаю помогает
рабочий: рабочая рабочем рабочих рабочей рабочего рабочий
образец: образцов образец
вновь: вновь
двигаться: движемся двигаться
ставить: ставивших ставят
серия: серии серию серия
перейти: перешло перейти
политический: политического политическую политическим политическая политический политическом политической политическими политическое политические политических
пытаться: пытались пытался пытаются
холм: холме
отечество: отечестве
руководство: руководства руководство руководством
социальный: социальная социальных социальные социальной социальную
баранов: баранова
парадоксальный: парадоксальная
дева: девы дев
рассмотреть: рассмотрены
помогаевой: помогаевои
задача: задач задачи задачей
причина: причина причины причинам причин причиной
известный: известную известная известного известна известных известный
дмитр: дмитров
повод: поводу поводом
сотня: сотни
каждый: каждого каждая каждый
фотообои: фотообои фотообоями
общественный: общественные общественного общественной общественное общественных
лагерь: лагерь
небольшой: небольшую небольшая
нефтяной: нефтяной нефтяного нефтяная нефтяных
статистика: статистика статистики статистику
грант: грант грантами гранты
шанинка: шанинку шанинка шанинке шанинки
препятствовать: препятствовало
smirnoffv: smirnoffv
традиционный: традиционной традиционного
материал: материалам материалом материал материалов материале материалу материалах материалы
aerys: aerys
уважать: уважали уважаю
http: http
свой: свои свое своим своего своих своем свою свой своей своему своё своими
мордовский: мордовского мордовские
жизненный: жизненный
политехнический: политехнического
тема: темы темах темам тема теме темой тему
выяснить: выяснила
использовать: используя использует используемых использованы
очевидец: очевидца очевидцев
всемирный: всемирной
объём: объем объему
сд: сд
рассказывать: рассказывающая рассказываю рассказывает рассказывал рассказывают
смотреться: смотрелся
основной: основной основные
учёный: ученым ученого ученой ученый ученых
малоизвестный: малоизвестное
моральный: моральным
покупать: покупают покупает
меркушкин: меркушкиным
прислать: пришли прислали
ярко: ярко
черников: черникова
научно-популярный: научно-популярная
коллективный: коллективное коллективную коллективной коллективная коллективного
считать: считаем считать считая считают считал считает считали считаю
многократно: многократно
солженицын: солженицына
продолжение: продолжения продолжение
империалистический: империалистического империалистические империалистической империалистическим
оставаться: остаётся оставаться остаюсь остается
направление: направления направлений направлению направление
разработка: разработки разработку разработке разработкой
знать: знать зная знал знаю знают знает знали знаете
похвастаться: похвастаться
миссия: миссия
служить: служил служить служит
курс: курсе курсов курсы курс курса
строго: строго
власть: властей власть власти властью
вино: вина
он: него он его ему нему
тысяча: тысячи тыщи
классический: классическое классические классической классическому
инфраструктура: инфраструктуры
миловый: милова милов
какой: какое каким какой какие
имя: имя имени
text: text
истребить: истреблены
выставка: выставка
игнорировать: игнорируют
страдание: страданий
зайти: зашёл зайду зашло
пищепром: пищепрома
многий: многих многим
белый: белое белый белых
где-то: где-то
изучение: изучением изучении изучению изучение изучения
юткевич: юткевича юткевич
вывод: вывода выводы
маоизм: маоизм
идея: идеями идея идей идеи идеях
речной: речного
корреспондент: корреспондентом корреспондент
отмалчиваться: отмалчивался
поэтический: поэтические
умелец: умельцы
рука: рук руки руках
расхожий: расхожие
схема: схемами схемы схема
поиметь: поиметь
никитин: никитина
соблазн: соблазна
земсков: земсков
жёстко: жестко
стол: стола стол столе
деятельный: деятельного
прогресс-москва: прогресс-москва
крайний: крайней
надзор: надзор
мотор: моторе
вспоминать: вспоминая
насколько: насколько
облегчить: облегченные
ты: тебе тебя ты
росспэн: росспэн
привет: привет
продемонстрировать: продемонстрировать продемонстрировали продемонстрировала
пол: полу
англия: англию англии
целостный: целостный целостное целостного
товарищ: товарищей товарища товарищи
пищевой: пищевой
техника: техника технике
бомжевать: бомжевать
актив: активы
сын: сына сыновей сын
узнать: узнает узнать узнал
сверху: сверху
стоять: стоят стояла
реакционный: реакционных реакционной
продукция: продукции
солнечный: солнечный
социал-реформистский: социал-реформистских
героически: героически
погрести: погребённое
римский: римским
сдать: сдали
управление: управление управлением управления
разительно: разительно
живой: живое живым живые
гитлеровский: гитлеровской гитлеровского
находить: находил находя
такой: такие такая такого такое таких такой таким такими такую
элита: элитам элите элита элиты
многообразие: многообразие
болезнь: болезнь болезней болезни
план: планы плане планах план планов
коллега: коллеги коллег
монополия: монополиями монополии монополиях монополий
электронный: электронных электронные электронном
получить: полученные получила получил получим получить полученного полученной получившей получили
маленький: меньше маленькая
кой: коих
живопись: живописи
понадобиться: понадобится
свадьба: свадьбе свадьба свадьбу свадьбы
вооружение: вооружений
осуждение: осуждении
фольклорист: фольклористов
спенсер: спенсер
заведение: заведениями заведений
постмодерн: постмодерна
дрязг: дрязги
сей: сей сих
авантюризм: авантюризм
принести: принесут принёс принеся принести
видеть: видели вижу видел видите видела
бросаться: бросаться
преимущественный: преимущественного
судоходство: судоходства судоходстве судоходство
обратно: обратно
нарушение: нарушение нарушения
мочь: может могут могло мог могли могу
приводить: приводя приводят
дмитриевич: дмитриевича
there: there
иметь: имеет имело иметь имели
читать: читают читать читает читал читаешь
журнал: журнала
смысл: смыслов смысле
признанию-: признанию-
рассматриваться: рассматривался рассматриваются рассматривается
язык: языков языках язык языке
кейс: кейсов кейсы
дипломатический: дипломатическая дипломатической
изучать: изучать изучающих изучают
оцифровать: оцифровать оцифрованы оцифрована оцифровал
парень: парня
реваншист: реваншистов
публиковаться: публикуется
слово: слово слова словам слов
больший: большей большую большая большим наибольшим
обучаться: обучающихся
удар: ударов удар
гуманитарий: гуманитария гуманитариев
воззрение: воззрения
огромный: огромный огромной
древнерусский: древнерусские
зажать: зажали
состав: составе состава составу состав
военный: военный военные военное военной военным военная военную военных военного
компания: компаний компании
командование: командование командованию
украина: украиной
писать: писать писали писал пишу пишет пиши пишут
вещь: вещам вещами
штат: штата штатов штатах штат штате
железнодорожный: железнодорожная железнодорожному железнодорожное железнодорожного железнодорожный железнодорожную железнодорожных железнодорожном железнодорожной
английский: английскими английских английского английский
сбить: сбитый
инженерно-технический: инженерно-технических
posted: posted
практический: практической практическими практические практических
банальность: банальности
разный: разные разным разных
нет: нет
находиться: находится находилось
проблема: проблеме проблема проблем проблемам проблемы проблемами
книжный: книжную
сократить: сокращенный
освещаться: освещаются освещается
интересоваться: интересуется интересующихся интересующимся интересующиеся
мессершмитта: мессершмитт
мамонтов: мамонтова
балбес: балбесов
брежнев: брежнев
выступать: выступать
фиксировать: фиксирующий
привозить: привозили
фактор: факторы факторов
евгений: евгения
доставить: доставил доставила
привезти: привёз привезенного
усиление: усиления
беременная: беременными
издать: издать изданному
обществоведение: обществоведения обществоведении
пролетарий: пролетарии
деиктический: деиктический
житьё: житьё
быть: суть буду было была был быть будет были е будем будут
публикация: публикаций публикации публикацию
пятилетка: пятилетки
воспроизводиться: воспроизводящиеся
простой: простые проще
справляться: справляется
высказаться: высказаться
определение: определение определения определению
углич: углич
застойный: застойных застойные
написать: написана написанная написала написанном написать написанную написали написал написан написано
извратить: извращенной
судзук: судзуки
предложить: предложила предложить
александр: александр александром
происходить: происходит происходило
пропасть: пропасти
работа: работе работой работу работ работы работам работа
образование: образование образования образованием образованию
соцсеть: соцсети
принцип: принципов принципа принцип принципы принципам принципе
ограничение: ограничение
мы: нас нами мы нам
дооктябрьский: дооктябрьский
выйти: вышедший вышли выйдет
индокитайский: индокитайский индокитайского
централизовать: централизованного
частный: частных
принятие: принятия принятие
университет: университетов университета университет университетах
тратить: тратить
please: please
повествовать: повествует
компартия: компартий
обыкновенно: обыкновенно
скупить: скупить
офисный: офисные
описываться: описывается
принципиальный: принципиальные
проклинать: проклинать
поступательный: поступательное
прочий: прочие прочую
хобби: хобби
железный: железной железные железных
культура: культура культуре культуры культуру
гост: гостам госты
широкий: широкую широкие широкий широкой широкого широким широкому шире
ссылка: ссылку ссылка
отец: отец отца
крепко: крепко
финансово-нефтяной: финансово-нефтяных
цаголов: цаголов цаголова
количественный: количественного количественное
недовольный: недовольных
посвятить: посвященную посвящена посвященные посвящены посвященная посвященный посвящен
принадлежащий: принадлежащая
неистовый: неистово
руководящий: руководящий руководящему
попытка: попытки попытками попытку попытка попытке
петров: петрова
национально-освободительный: национально-освободительной национально-освободительного
официальный: официальных официальными официальное
никакой: никакой никакого никакие никакая
советский: советских советскому советская советскими советским советские советской советского советский советском советскую
кормить: кормили кормить
сср: сср
отрасль: отрасль отрасли отраслей
обзор: обзор обзором
организовать: организовать организованы
отечественный: отечественную
стабилизатор: стабилизаторы
ленинградский: ленинградского ленинградское ленинградский
угол: углом
приниматься: принимается принимались
массовый: массовый массового массовым массовом
который: которая которой которое котором которых которые который которого которую которым которому
мнимый: мнимыми
причинно-следственный: причинно-следственные
доц: доц
любой: любое любого любым любой любом любых любая
основа: основу основе основ основы основа основам
чих: чих
совет: совета совет
дк: дк
вызывать: вызывает
нельзя: нельзя
небытие: небытиё
немец: немец
нэп: нэп нэпа
подумать: подумал подумать
есть: ел есть
тележурналист: тележурналист
сводиться: сводится
мадлен: мадлен
ива: ив
осудить: осуждены
народ: народы народа народ народов
применение: применением применения
разбираться: разбирается
шемяк: шемяки
ранговый: ранговая
процесс: процессу процессе процесс процессов процессы процесса
интернет: интернет интернета интернете
исторический: историческом историческими исторический историческую исторические исторической исторических историческая
провести: провела проведен
officer: officer
нестеров: нестерова
политработник: политработники
учить: учить учат учит
знакомый: знакомых
продолжать: продолжаем
разрабатывать: разрабатывал
размышление: размышления
произойти: произошли произошло произошёл
узкий: узкое
афганистан: афганистан афганистана
дядя: дядю
экономика: экономику экономикой экономике экономики экономика
желать: желала
журналист: журналистов
уведомление: уведомление
сооружение: сооружение
прослеживаться: прослеживается
сделать: сделанному сделал сделаешь сделает сделали сделать
скрытый: скрытой скрытый
че: че
вырасти: вырастут вырасти
хозяин: хозяин
значительный: значительный значительная
уехать: уехали уехал
xx: xx
государство: государства государство государств государством государствами
дорога: дорогой дорогам дороге дороги дорог дорогах
левый: левые левой
возраст: возрасте
ранг: рангом
пушкин-историк: пушкину-историку
очерк: очерки
использование: использования использование использованию
интересовать: интересует интересовало
опал: опале
формула: формул формулы
рынок: рынки рынка рынке
отсутствие: отсутствия отсутствие
оцифрованный: оцифрованных
региональный: региональных региональным региональная региональную региональные
предлагаться: предлагается
брат: братьев
лященко: лященко
говорить: говорить говорит говорят говоря говорили говоришь
конфликт: конфликты конфликтов
перерыв: перерывов
история: истории историей историю история
приезжать: приезжали приезжать
руль: рулём
почва: почву почве
соревноваться: соревнуются
уметь: умел умеют
бунт: бунт
звучать: звучит звучат
видимо: видимо
факт: факты фактов фактах фактам факт
школа: школы школе школа
коммунист: коммунист коммунистов
политически: политически
венесуэла: венесуэлы
упоминать: упоминал
хозяйство: хозяйстве хозяйству хозяйство хозяйством хозяйства
эластичность: эластичности
проводить: проводимой проводил
ружьё: ружьем
большой: большое большой больше
штаб: штабы штаб штабу
переживать: переживаю переживает
м: м
широко: широко
боннский: боннского боннских
норма: нормам
трактовка: трактовке
зенит: зенит
отвлекаться: отвлекайтесь
помешать: помешали
этот: эту этому эти этот эта этих этой
социалистический: социалистического социалистической социалистическое социалистические
страх: страх страха
афанасьев: афанасьев
эмигрантский: эмигрантской эмигрантских
грузовладелец: грузовладельцев
допустить: допустим допущено допустить
брошюра: брошюр брошюру брошюре брошюра
пройти: прошла прошёл пройдёт
активно: активно
противодействие: противодействие
позарез: позарез
сыграть: сыгравшем сыграла
п: п
грустный: грустной
буржуазный: буржуазные буржуазная буржуазный буржуазной буржуазных
хаак: хаак
рукопись: рукописи
at: at
ответ: ответ ответы
заяц: зайцев
конъюнктура: конъюнктура
капитальный: капитальных
отвергать: отвергаем
рассчитывать: рассчитывать рассчитываю
сносный: сносным
кусок: куски кусок
плохой: плохих худшем плохое
расти: растет
случай: случае
внести: внес
таня: тани таней таня
суд: суде
молотый: молотые
предлагать: предлагаю предлагаемой предлагает предлагать предлагают предлагаемая
эпизод: эпизод эпизодах эпизоды
превышение: превышение
современный: современного современных современные современное современной современный современная современном
сода: содой сода
арендовать: арендованных
иезуит: иезуиты
влиться: влилась
часть: частью части часть
русификация: русификация
выбирать: выбирать
найти: нашло нашел найдёт найти нашёл найдет найдена найдут
эксплуатировать: эксплуатировать эксплуатируя
догма: догмы догма
искусствоведение: искусствоведения
характерный: характерных
преимущественно: преимущественно
пример: примере примеру примера примеры
посчитать: посчитало
вн: вн
учиться: учусь учились учащихся учиться
перевод: перевод переводов переводе
умный: умными умнее
торжественный: торжественных
расследование: расследование
отчёт: отчетов отчет
дореволюционный: дореволюционных
слабый: слабой слабое
длительный: длительного
систематизировать: систематизированное
век: века веков вв
совершенствование: совершенствования
польза: пользе пользы
поздравление: поздравления поздравлений
богато: богато
скарамуш: скарамушу
дружно: дружно
наука: науку науки науками наук наука науке
тигель: тигель
абзац: абзацев
марена: марен
i: i
регион: регионы регионов регионе региона регионам
термин: термин термина
капитализм: капитализме
туда: туда
завершиться: завершился
ответственность: ответственность ответственности ответственностью
замдиректора: замдиректора
тп: тп
ленинград: ленинград
нобелить: нобели
исследовательница: исследовательницы
люфтваффа: люфтваффе
экономист: экономистам экономист экономиста экономисты
пообсуждать: пообсуждать
малый: малой малый меньшая
инженер: инженеров
самый: самая самых самым самый
единый: единое единого единой единый
доходчивый: доходчивыми
кратко: кратко
обрезать: обрезал
кубик: кубик кубиков
читатель: читателей читателем читателя читатель читателям читателю
общемировой: общемировой
капиталистический: капиталистическом капиталистической капиталистических капиталистическими
это: этим этом этого
психоз: психоз
толкователь: толкователи
потрындеть: потрындеть
звено: звеном
занимать: занимающим занимающие занимает занимают
грустить: грустит
статус: статуса
соединить: соединенных соединить
правительство: правительства правительство правительству
ипшник: ипшниками ипшников
очень: очень
наводить: наводит
меновой: меновой
мысль: мысли мысль мыслей
свободолюбивый: свободолюбивых
ездить: ездит ездил ездят
кануть: кануть
вопрос: вопросе вопросов вопрос вопросы вопросам вопросу вопросами
буржуазно-помещичий: буржуазно-помещичий
доверять: доверять
ночью: ночью
особенность: особенности
транспечать: транспечать
сторона: стороны стороне сторон
коралловый: кораллового
понятие: понятий понятия понятие
сила: силами силу сила сил силы
замечательный: замечательного замечательные
беседа: беседы бесед
качество: качестве качество качества качеством
врач: врач
победный: победнее
треть: треть
kниra: kниra
царизм: царизм
член-корреспондент: члена-корреспондента
менее: менее
огонёк: огонек
сталинский: сталинской сталинская
усилить: усилили усилить
придумка: придумка
сюрный: сюрные
полезный: полезная
мк: мк
мировой: мирового мировой мировая мировую мировое мировом
являться: являются является являясь
чёрно-белый: черно-белый черно-белые
газель: газель
экономико-статистический: экономико-статистический
хозрасчёт: хозрасчет
сотрудничать: сотрудничал
отводить: отводят
изготовление: изготовления
ребёнок: детей дети
актуально: актуально
l: l
повесить: повесили
тариф: тарифы тарифами тарифов
лс: лс
китаист: китаистом
получать: получает получаем получать
деятель: деятелей деятелями деятели деятеле деятель
блестящий: блестящим блестящую
архаизация: архаизацией
основать: основано
удовлетворять: удовлетворять
входить: входят входит
редко: редко
впечатление: впечатлению впечатлений впечатления
помочь: поможет помочь
тираж: тиражом
эрлихо: эрлих
принципиально: принципиально
нью-йоркский: нью-йоркская
вьетнамский: вьетнамского вьетнамских
—: —
учёт: учет учета учетом
хлеб: хлеба хлеб
текстовый: текстового текстовый
иго: ига
бумага: бумаги бумагу бумаге
подталкивать: подталкивает
велита: велит
том: тома томах томе
автомобильный: автомобильный
хлевнюк: хлевнюка хлевнюк
поздний: позднее позже
легко: легко
насаждать: насаждаемый
экономический: экономическая экономическую экономических экономический экономической экономического экономические
выбор: выбора выбор
серьёзно: серьезно
тот: та те той ту том того тот тому тех
работать: работает работать работало работала работал
антон: антон
нарратив: нарративов нарративы
вл: вл
нотка: ноткам
пора: пор поры
г: г
эксмо: эксмо
роль: роль роли
делать: делали делают делать
половой: половым
рейган: рейгана
навскидку: навскидку
десятилетие: десятилетия десятилетий
скан: сканов сканами скан сканы
месяц: месяцев
символика: символики
отзыв: отзывы
расстроить: расстроенных
прокоммунистический: прокоммунистических
москва: москвы москва москву москве
отзывчивый: отзывчивого
издавать: издавали издавать
стабильность: стабильности
важный: важную важный важнейших важнейшие важным важных важнее важной
наконец: наконец
военно-стратегический: военно-стратегические
этология: этологии
ценность: ценность ценности
механизм: механизм механизмы механизма
выписывать: выписывать
возродить: возрожденного
корень: корни корней
привести: приведшей приведены привели
обращение: обращения
публично: публично
собранный: собранный
мит: мит
закон: закон законов законах
просмотр: просмотра
самолично: самолично
вести: ведут ведет вести
свободный: свободного свободной свободное
особо: особо
френд: френдов френдами
ряд: ряд ряда ряде
иллюстрировать: иллюстрировано иллюстрирована
остановить: остановит
представление: представления представлений представление
методологический: методологические
порождать: порождает
нанести: нанесен
оборот: обороты оборот
сравниться: сравниться
неизвестный: неизвестные
наш: нашим нашего нашем наши нашей наших наше наш
одновременно: одновременно
внешнеполитический: внешнеполитических внешнеполитическая
заниматься: заниматься занимающихся занимаются занимались занимался
объединить: объединенное объединенному объединить
россыпь: россыпи
доходить: доходят доходили
бот: бота
всегда: всегда
применять: применять применяем применяют
идеологический: идеологической идеологический идеологические идеологических
опыт: опыту опыт
источник: источника источниках источниками источники
вечер: вечерам
ясный: ясный
необычный: необычная
свидетельство: свидетельством свидетельства
протест: протесты
экономически: экономически
критический: критический критическому критическом
извиняться: извиняюсь
ядерный: ядерного ядерной
опубликовать: опубликованы опубликовал опубликованных
падение: падений
академик: академика
война: война войне войн войны
связанный: связанные связанных
джоп: джопом
строить: строить
придумать: придумал придумать
жёсткий: жёстче
генетика: генетике генетики
память: памяти память
мег: мегов
юго-западный: юго-западной
художественный: художественных художественного художественная художественной
некоторый: некоторое некоторые некоторых некоторой
зеленоград: зеленограде
влияние: влиянием влияние влиянию
экзистенциальный: экзистенциальный
закром: закромах
сидоров: сидорова
filesvmru: filesvmru
преподаватель: преподавателей преподавателям
газета: газеты
горячий: горячие горячую
ненастоящий: ненастоящий
традиция: традицию традиции традиция
исследователь: исследователями исследователей исследователи исследователь исследователя
время: время времен времён времени временах
вводить: вводит вводимых
ежегодно: ежегодно
атака: атаку
джс: джс
готовый: готов
гора: гора
генеральный: генерального генеральные генеральному генеральный
земля: землю земле
маоистский: маоистском
десятка: десятки
чтение: чтении чтением
суть: сути
послужить: послужила послуживших
демонстрировать: демонстрирует
crutch: crutch
торговля: торговля торговле
историк: историки историк историка историков
неуверенность: неуверенность
воин: воинов
непонятный: непонятного
невкусный: невкусными
присутствовать: присутствуют
нравиться: нравится нравились
сожаление: сожалению
развиваться: развивается
эссе: эссе
павлович: павловича павлович
орган: органа органов
студент: студента студент студентов студентам студенту
другой: другого другими другую другие другая другой других
место: месте местах место места
готовить: готовя готовить
фотоаппарат: фотоаппаратом
модерн: модерн
диктатура: диктатуры диктатура диктатуре
партийный: партийной
сенат: сенат
класс: классу класса
непрерывный: непрерывная
учебно-методический: учебно-методическим
д-р: д-ра д-р
оформлять: оформлять оформляли
беспокоиться: беспокоились
микроэкономика: микроэкономики
найтись: найдутся нашелся
индокитай: индокитая индокитае
повторение: повторения
грешить: грешит
амаршалл: амаршалл
брошюрка: брошюрке
пнуть: пнёшь
гомеопатия: гомеопатия гомеопатии
квалификация: квалификации
позитивный: позитивную
педагогический: педагогических
книга: книгой книгу книга книгах книги книг книге
октябрь: октября октябре
жёлтый: желтого
вест-пойнт: вест-пойнт
подобный: подобное подобные подобным подобная подобного
ваш: вашему ваше
дело: деле дел дела делам дело делом
сообщение: сообщения
донесение: донесения
середина: середины середине
уйти: ушли
представитель: представителями представителя представителей
право: прав право праве правах права
дойти: дошли дойдя
низкий: низкого
слух: слуху
приготовить: приготовил
составить: составленный составит составить
жена: жене жен жены
сражаться: сражаются сражалось сражающихся
экспорт: экспорте экспортом
сша: сша
семья: семьи семье
уникальный: уникальный уникальной
gentelman: gentelman
описывать: описывал
возглавлять: возглавляет
планово-управленческий: планово-управленческих планово-управленческой
трудиться: трудиться
шаг: шаг
успех: успеха успехи
престижный: престижной
акахат: акахата
национальный: национальный национальной национальная национального национальных национальном
фотограф: фотограф
ред: ред
собственный: собственной собственному собственные
армия: армию армии армия
мало: мало
забытый: забытые
catofoldmemorylivejournalcom: catofoldmemorylivejournalcom
счастливый: счастливую
система: систему системе системы система
обработать: обработал обработан обработают
манипулировать: манипулировать
перестроечный: перестроечные
восстановить: восстановил восстановить
райнхарт: райнхарта
миронич: миронич
налог: налог налогу
развлекать: развлекали
мнение: мнение мнениям мнению
приходить: приходит
вечный: вечное вечную вечный
беда: беда
университетский: университетскому
вовсе: вовсе
роды: родов
конспект: конспект
всесоюзный: всесоюзный всесоюзного
нормальный: нормальный нормальную нормального нормальное нормальные
петербург: петербург
бонус: бонуса
сказать: сказать сказала сказано скажет сказанным сказали
полевой: полевых
historia: historia
человек: человеком людей люди людям людьми человека человек
юрид: юрид
врать: врали врать
устав: уставе устава
чувствовать: чувствую чувствует
разоблачать: разоблачает
ломов: ломова
ящик: ящик
продавать: продавать
одобрительный: одобрительные
получаться: получалось получается
вопрошать: вопрошал
познавательный: познавательный
граница: границу границы границей
организация: организация организациями организаций организации
радость: радость
что: чём чего чему
второй: вторым второй вторую второго вторая вторых
американский: американского американских американская американские американском американский американским американскими американской
буккроссинг: буккроссинге
кхер: кхерам
цк: цк
лишний: лишней лишним
ссылаться: ссылаться
рассказ: рассказ
избирательный: избирательная
выстраивать: выстраивают выстраивать
союз: союза союзов союз союзы союзе
очевидный: очевидно очевиден
просёлочный: проселочным
передача: передача
ботая: ботаю
заканчиваться: заканчивается
тратиться: тратились
социалист: социалистов
религиовед: религиоведы
банда: бандам
состояние: состояние состояния состояний
лекарство: лекарства
редактор: редакторы редактор редакторов
рогресс: рогресс
безликий: безликие
делиться: делятся
путешествие: путешествия путешествие
исток: истоки истоков
греция: греции грецией
андерграундный: андерграундная
японский: японских японского японским
альтернативный: альтернативной альтернативная альтернативные
выпуск: выпуске выпуск выпуска
блог: блог
кишинёв: кишинев
прийти: пришедший пришёл пришел придет
изложить: изложен изложенной изложил изложить
картоха: картохи картоха
гражданский: гражданской гражданских гражданское
высокий: высших высшее высшего высший высокой высоких высшая
довоенный: довоенные довоенный
горький: горького
повсюду: повсюду
общий: общие общем общих общего общая общую общий общее общей
рождение: рождения
торговый: торговых торговые
воздействие: воздействие воздействия воздействию воздействием
плановый: плановые планового плановых
смерть: смерть смерти
казаться: казалось кажется
пугачёв: пугачеве
избавиться: избавиться
вид: видами видов видам виде вид
дополнять: дополняем
поддерживать: поддерживал поддерживала
построиться: построилась
неоткуда: неоткуда
катрин: катрин
ри: ри
двадцатый: двадцатых
картошка: картошки картошку
голова: голову голове головой
черта: чертах черты
западный: западную западном западных западный западная
вместе: вместе
завершать: завершаем
обратить: обратите обратить
мартин: мартина мартин
администрация: администрации
левицкий: левицкой
тематика: тематику
раскрытие: раскрытии
заставить: заставил
ричард: ричард
сфера: сфере сферой сферах
публицистический: публицистической публицистическое публицистические
реакция: реакции
невозможность: невозможность
дух: духе духом
гибель: гибели
периодический: периодическими
ещё: еще ещё
отдача: отдачу
крутой: круче крутого
гонка: гонку
посвящать: посвящаю
сложиться: сложившихся сложилась
раздумье: раздумий
ниспровержение: ниспровержению
бельковый: бельков
ов: ов
партия: партий партии
германия: германии
произвольно: произвольно
даманский: даманский
общественность: общественность
профессионализм: профессионализм
последний: последний последние последнем последних
выстраивание: выстраивания
необходимый: необходимые необходим
удовольствие: удовольствием
цвет: цвете
автономия: автономий автономии
день: дней дни днях дня
умирать: умирать умираешь
республика: республики республика
михалков: михалкова
собиратель: собирателя
подвижный: подвижном
что-нибудь: что-нибудь
перегнать: перегнать
местный: местным
позиция: позиций позициям позиции
живо: живо
остров: острове
ведомство: ведомством ведомств
кофеварка: кофеваркой
появиться: появилось появившиеся появившийся появилась появился
приписывание: приписывание
оригинал: оригиналов оригинале оригинал
открытый: открытой открытые открытое открытую
сложный: сложное
упомянуть: упомянуть
„прогресс: „прогресс
промышленность: промышленность промышленности
способствовать: способствует способствовал
собака: собаки собак
пользоваться: пользуясь
погонял: погонялами
обстановка: обстановку
классика: классикой
тупо: тупо
сказка: сказок
вероисповедание: вероисповедание
исследование: исследования исследование исследованием исследований
магритта: магритт
вопиять: вопиющее
комплексный: комплексного комплексным комплексных
мама: мама маме
глобализация: глобализация глобализации
концерн: концерн концерна концернов концерне
настоящий: настоящем настоящее настоящий настоящего настоящей
описать: описан описано описанным
производительность: производительность
морской: морских морская морском морского
мастерство: мастерство
авторский: авторским авторской
полезно: полезно
революционный: революционной революционном революционный
стюарт: стюарт
проходной: проходное
осведомление: осведомление
долгий: долгое долгие
фашизация: фашизации
появление: появления
атлантида: атлантидой
разовый: разовые
конъюнктурный: конъюнктурном конъюнктурного
дж: дж
недостаток: недостатки
уголовный: уголовного уголовной уголовном
военно-промышленный: военно-промышленных военно-промышленном военно-промышленного
группа: группы групп группу группой группе
молоко: молоко молоком
кхмерский: кхмерской
любопытный: любопытная любопытную любопытное любопытных
гомель: гомель
нация: нации нация нацией наций нацию
репрезентация: репрезентация
иной: иные иную иных иного иной
теперь: теперь
выращивать: выращивая
нефть: нефти нефть
название: название названия названию
думать: думать думаю думал
говорящий: говорящей
резников: резникова
документ: документы документов
дифференциация: дифференциации
просить: просят прошу просили
пост: поста пост постах
правильный: правильное правильную правильных правильный
раяцкас: раяцкас
распространить: распространить
революция: революцией революции революцию революций революция
обмануть: обманутые
фактический: фактический фактическую фактическом фактическому
находка: находке
равновесие: равновесия
вшэ: вшэ
четвёртый: четвёртой
капитолийский: капитолийском
будущее: будущее будущем будущего
ирландия: ирландии
китай: китаем китае китая китай
пять: пять пятью
окружить: окруженный
страница: страницах страницы страницу страниц страница
отбор: отбор отборе
отредактировать: отредактированные
франсэз: франсэз
журналист-международник: журналиста-международника журналист-международник журналистов-международников
избранный: избранные
действие: действие действий
препод: преподу
века—предпринять: века—предпринял
толстой: толстой толстого
переписка: переписка
знакомство: знакомства
россия: россией россии россию россия
ельцин: ельцина
заговорщик: заговорщиках
глаз: глазами глаз глаза
осторожно: осторожно
бифрол: бифролов
институционализация: институционализации
учебный: учебное учебного учебном учебными учебных
дженерало: дженерал
философия: философия
настораживать: настораживало
рамка: рамках рамки
арканзас: арканзас
обращаться: обращается
пособие: пособия пособие пособии
уксус: уксусом
выслушать: выслушал
осветить: освещены
драматургия: драматургии
интеграция: интеграции
кпсс: кпсс
русский: русского русских русские русском русская русской русскую
оценка: оценку оценки
хачатуров: хачатуровым
рассыпаться: рассыпалась рассыпающиеся
второе: второе
vas-s-allivejournalcom: vas-s-allivejournalcom
громадный: громадной
доклад: докладом доклады доклад
коткина: коткин
фёдор: федор
кризис: кризиса кризис кризисе
предполагаться: предполагается
восток: востоке востока восток востоку
гусефф: гусефф
юханан: юхананов
кузьмин: кузьмин
грызня: грызня
поездка: поездок поездка поездке
смит: смитом
межгосударственный: межгосударственные
смена: смену
товарный: товарного
кандидат: кандидата кандидат
судьба: судьбу судьба судьбе
называться: называется
покровский: покровского
третий: третий третьего третьем
народ-художник: народ-художник
yadisk: yadisk
отдел: отдела отдел
приход: приход
философ: философа философ
теоретик: теоретик теоретиком
речь: речь речей речи
уверенность: уверенность
решение: решение решении решений решению решения
освещать: освещает освещающий
магазин: магазин
минимум: минимум
нрав: нравах
они: ими ними они их ним них им
оптимизация: оптимизация оптимизациях
дать: дать дала данные дан данному дано даны
марэн: марэна марэн
предмет: предметы предмет предмете предметом
публиковать: публиковать публикуемом
крестьянин: крестьяне
адекватный: адекватной адекватное
рахимов: рахимов
географический: географическую географических географическая географическом географический
античный: античного
выразитель: выразителя
раскладывать: раскладывать
правда: правду
современник: современников
разуметься: разумеющееся
лайфхак: лайфхак
дальний: дальний дальнего
великодержавный: великодержавных великодержавного
пересадочный: пересадочные
зрение: зрения
кибернетика: кибернетики кибернетика кибернетикой
•: •
парадокс: парадокса
опасаться: опасаюсь
коэн: коэн коэна
относиться: относитесь относящихся относились относится
мерка: меркам
соотноситься: соотносится
отродье: отродьем
яртый: яртых
проваливаться: проваливается
феодальный: феодальной феодальная
вскрываться: вскрываются
государственный: государственного государственных государственный государственной государственное
хорст: хорст
отчётность: отчетности
авангард: авангард
рассмотрение: рассмотрение
подгот: подгот
слышать: слышал слышишь слышали
кёсорёк: кёсорёку
заглянуть: заглянул загляните
многокритериальный: многокритериальная
горечь: горечь
фас: фас
главный: главный главным главные главную главной главных главная
твориться: творится
путать: путать
признаться: признался
афишировать: афишировал
определённый: определенных определенным определенный определенную определенного
рассматривать: рассматриваемых рассматриваемая рассматривает рассматривают
моррис: морриса моррис
метод: методах методов методы
отличие: отличиям отличие
дэвид: дэвид
ен: ен
оппонент: оппонентов
фантаст: фантасты
линия: линии линия линий
основное: основном
провокация: провокаций провокации
оба: обеих
магнитный: магнитная
сравнить: сравнить
пафосный: пафосных
военизированный: военизированных военизированные
советовать: советуют советовали
еу: еу
рассказать: рассказать рассказали
технично: технично
сближение: сближению
условие: условиях условий условие условия
идеология: идеологии идеология
достижение: достижение
китаец: китайцах
внучка: внучка
богатый: богатых побогаче богатые богатой богатый
тихо: тихо
салатик: салатики
евгениевич: евгеньевна
чужой: чужих
последствие: последствиям последствия последствий
ям: ям
итало-немецкий: итало-немецких
альянс: альянс
интеллигенция: интеллигенции
водитель: водители
михайлов: михайлов
когда-то: когда-то
отмечать: отмечают отмечает
меланж: меланж
зачем-то: зачем-то
прислушиваться: прислушивался
полоса: полосами
массово: массово
обрабатывать: обрабатывал обрабатываешь обрабатывать
кругозор: кругозором
осознать: осознал осознать
снаружи: снаружи
розанов: розанова
кошка: кошках кошки кошек
суслов: суслов суслове суслова
общественно-политический: общественно-политической
тесный: тесный тесной
транспортный: транспортное транспортных
переиздаваться: переиздавался
мелкия: мелкии
стоить: стоили стоит стоить
движение: движенье движения движении движение
городецкий: городецкому
здоровье: здоровье
ocr: ocr
оптимальный: оптимального оптимальные
михневич: михневич
среда: среде среду
венгрия: венгрии венгрию
скотина: скотину
ебанутой: ебанутое
печать: печати печать
произвести: произвести
майор: майор
провал: провал провалы
антология: антология
милитаристский: милитаристский
прелюбопытный: прелюбопытные
потихоньку: потихоньку
наступить: наступившего
подготовить: подготовленный подготовил подготовлен
отражение: отражению отражение
народнохозяйственный: народнохозяйственного
мясо: мясо мясом
телега: телега
перу: перу
контрреволюция: контрреволюции
эволюция: эволюция эволюцию эволюции
военнослужащий: военнослужащего
ivanstor: ivanstor
вступительный: вступительная вступительный
дмитрий: дмитрия дмитрий
поликлиника: поликлинике
аналогично: аналогично
кнр: кнр
участник: участников участника участники
кокусё: кокусё
ампо: ампо
воссоздавать: воссоздают
скромность: скромности
сухой: сухого сухое сухим
получиться: получилось получились
министр: министров
князь: князьям князья
фактура: фактуру
кан: кане
завершить: завершить завершена
новизна: новизны
сволочь: сволочь
продолжительный: продолжительная
создание: создании создание созданию
абстрактность: абстрактность
удобный: удобный
перекись: перекисью перекись
хотеть: хочу хотел
отойти: отойдем
динамика: динамику
написание: написания
огаснуть: огас
унифицировать: унифицировать
область: областями области областей область
какой-либо: какая-либо
коммент: комментом
жизнь: жизнь жизнью жизни
число: число числе числом
понимать: понимаешь понимает понимаю понимать
искусство: искусства искусством искусство искусстве
подробный: подробнейшим подробная
позволять: позволяли позволяющим позволяет
предавать: предающих
ознакомление: ознакомления
загнивать: загнивающий
произведение: произведения
ткаченко: ткаченко
гость-то: гостей-то
монографический: монографическим
делаться: делается
где: где
нужный: нужны
кулешов: кулешов
вооружённый: вооруженными вооруженной вооруженных
ожидать: ожидаемый
стараться: стараясь
евтушенко: евтушенко
ма: ма
григорьянц: григорьянц
какой-то: какие-то какой-то какого-то
статья: статьи статье статья статью
записать: записал
раз: раза раз
тарифный: тарифного тарифную
лейтенант: лейтенанта
голый: голая
обращать: обращать
высокоразвитый: высокоразвитую
несколько: несколько
хаотический: хаотического
диктоваться: диктовалась
акад: акад
мужчина: мужчину мужчина
свет: свет свете
идентификация: идентификации
касаткин: касаткиной
умерший: умершего
ироничный: ироничный
„наука: „наука
половина: половины половину половина
набор: набор наборы
мелкобуржуазный: мелкобуржуазной
тут-то: тут-то
иностранец: иностранцев иностранцами
становление: становление становления
красный: красного красный
ву: ву
зависимость: зависимость
исследовать: исследованы
строитель: строители
показываться: показывается
почать: початая
затрагивать: затрагивающее
федерация: федерацией федерации
уровень: уровень
сибирский: сибирское
волнующий: волнующий
вчера: вчера
увидеть: увидеть увидел увидит
стратегия: стратегий
глубокий: глубокого глубокую
составлять: составляют составлять составляла составляющем составляющие
сентябрь: сентябрь
страховой: страховое
радио: радио
опус: опусов
вступа: вступ
оправа: оправе
vassal: vassal
газировка: газировка
капиталовложение: капиталовложения
платье-то: платье-то
отжать: отжать
платить: платить
марксизм: марксизма марксизм
взять: взял взяла взятой взять взят взявший
гигант: гигант гигантов
притворяться: притворяться
масуслов: масуслов
устремляться: устремляется
поистине: поистине
второстепенный: второстепенных
существование: существования
специалист: специалистов специалиста специалистам специалист
положительный: положительной
гвардия: гвардия
прошлое: прошлым прошлого
стекло: стеклу
показывать: показывает показывали показывают
блом: блом
структура: структуру структуре
гомеопат: гомеопатов
летописец: летописца
народный: народной народных народного народное народном
любить: люблю
почему: почему
издательство: издательством издательство издательстве издательства
глупость: глупости
логика: логики логику логика
ночь: ночь
начать: начать начавшего начали начал
фуражка: фуражку
рикардо: рикардо
гн: гн
договор: договора
фальсификатор: фальсификаторы
наблюдение: наблюдение наблюдений
автодорожный: автодорожный автодорожного
монополии-: монополии-
рой: роя рой
посконный: посконно
борьба: борьба борьбе борьбы
напоминать: напоминаю
минск: минск
грылевый: грылев
вполне: вполне
xix: xix
король: королей
средоточие: средоточием
община: общины община
размытость: размытости
показать: показан показаны показала показано показать
экон: экон
русь: руси
ю: ю
должный: должен должны должна
лежать: лежало лежит
большевик: большевики
предположить: предположить
социал-демократ: социал-демократы
цепь: цепи
расширение: расширения
фильм: фильма фильмов фильме
башкиров: башкиров
пучина: пучину
всемерно: всемерно
новосибирский: новосибирского
послевоенный: послевоенных
прибыль: прибыль прибыли
рекомендация: рекомендации
империя: империя империи
свергнуть: свергнуть
подстёгивать: подстегивающих
жанр: жанр жанров
функция: функция
руководить: руководит
лихорадка: лихорадка
называть: называемой называют
умение: умения
напрашиваться: напрашивайтесь
подробно: подробно
сознание: сознании сознанием
развитие: развития развитием развитие
земский: земские
везде: везде
козырев: козырев
центральный: центральная центральное центрального центральной
концепция: концепции
завоевательный: завоевательных
почётный: почетное
улица: улица
грязный: грязного
рот: рту
цивилизация: цивилизации цивилизация
позвать: позовёте
лето: летом
переход: перехода переход
метро: метро
кампания: кампания кампании
катастрофа: катастрофы
понятно: понятно
весь: всю весь всех вся всей всего всем всему
кейнс: кейнса
слабо: слабо
разбирать: разбирает
влксм: влксм
лвмиловый: лвмилова
природный: природную
родный: родной
биография: биографию
пул: пул
вы: вы вам вами вас
сохё: сохё
яркий: яркой яркий
текст: тексты тексте текста тексту текст
приложение: приложение
гэлбрейт: гэлбрейта
радикализация: радикализации
всячески: всячески
слезкина: слезкин
статистический: статистический статистическом статистического статистические
истый: ист
розария: розарии
заранее: заранее
нужно: нужно
пограничный: пограничных пограничной
камаз: камазов камазы
противоречить: противоречит
крейнина: крейнина
дочка: дочки
счастие: счастья счастье
присвоить: присвоил
версия: версия версию
мир: мира мир мире миру
аагригорьянц: аагригорьянц
изъятие: изъятие
бомбануть: бомбануло
аспр: аспр
пропиарить: пропиарю
одинаковый: одинаковой одинаковый
прораб: прорабы
закрывать: закрывает
сабашников: сабашниковых
влиять: влияющих
экран: экраны
поэтика: поэтику
занести: занесет
абсолютный: абсолютной
висеть: висит
чувство: чувств
моторз: моторз
таковой: таковой
писатель: писателей писатель
южновьетиамский: южновьетиамские
течение: течение
развернуть: развернутое
весьма: весьма
интерес: интерес интересов интересам интересы интересами
обезвоживание: обезвоживание
отметить: отметить отмечено
формально: формально
московский: московский московские московского
настроение: настроениями
маяковский: маяковского
сначала: сначала
кривая: кривые
культурный: культурных культурной
фицпатрик: фицпатрик
задавать: задают
союзник: союзниках
wolfkitses: wolfkitses
покойный: покойного
период: периода период периоды
сие: сего
острый: острейшем острой
ответственный: ответственный
мукитан: мукитанов
ждать: жду
трудящийся: трудящихся
далёкий: дальше
теоретический: теоретических теоретическую теоретической
открыватель: открыватель
неоценимый: неоценимый
особый: особый особое
мифический: мифической
оказываться: оказывается
водный: водный
переселить: переселены
фраза: фраза фразы
охуительный: охуительная
друг-гуманитарий: друзья-гуманитарии
занегин: занегин
требовать: требует требующих требуйте
ознакомительный: ознакомительного
суровый: суровом
давление: давлении давления
джонсон: джонсоном
сергиенко: сергиенко
популяризация: популяризация
пропагандист: пропагандистов
домашний: домашних
отъезд: отъезда
эффективность: эффективность эффективности
хлебный: хлебных хлебными хлебные
павел: павла
установка: установок
иерархия: иерархии
библиотека: библиотек
технически: технически
ситуация: ситуацию ситуация
трудность: трудности трудностей
внезапно: внезапно
обозрение: обозрение
удаться: удалось
российский: российских российские российской российскую российская российский
преподавание: преподавании преподавания
пенсильвания: пенсильвания
пракатастрофа: пракатастрофа
монопольный: монопольные
благосклонно: благосклонно
приходиться: приходится
раскрываться: раскрываются
эйфория: эйфория
сталин: сталин сталина
погоня: погоне
демократия: демократия демократии
and: and
димин: димин
фрактал: фрактал
определять: определяющих определять
население: население населения
раздел: разделами разделов разделы разделе раздел
край: края
построить: построить построил построенный построен
герд: герда
консервативный: консервативная
ленин: ленин ленина
цивилизованный: цивилизованных
построение: построения
вскрывать: вскрывают вскрывает
осуществляться: осуществляется
выступление: выступлениях выступления
доказываться: доказываются
включить: включены включенные
франция: франции
онтогенез: онтогенезе
желание: желанием
бе: бе
оформить: оформили
лень: лень
кочеврина: кочеврина
сканировать: сканирует
духовно: духовно
мера: мере мер меру
обобщение: обобщения
три: три трех
бесполезный: бесполезными
имперский: имперскому
кооперация: кооперацию
литературный: литературное литературную
кабыт: кабытов
добровольный: добровольной
мр: мр
реформа: реформ реформы реформа
средний: средней
дилетант: дилетанта
ключевой: ключевых
профессор: профессор профессора профессором
выражать: выражать
ответка: ответку
самарский: самарский
статут: статутом
би: би
общение: общения
всякий: всякая всякие всяких
общественно: общественно
утвердить: утверждена утверждено
давить: давит давил
борис: борисов
встречаться: встречались встречался
компиляция: компиляцию
ярославль: ярославль
большевизм: большевизм большевизма
военщина: военщины
интернет-пользователь: интернет-пользователей
западногерманский: западногерманских
успеть: успел
сухожилие: сухожилия
зарубежный: зарубежного зарубежные
max-andriyahovlivejournalcom: max-andriyahovlivejournalcom
республиканский: республиканский
ловить: ловит
пояснить: пояснил
взаимодействие: взаимодействия
пмв: пмв
гнуть: гнёт
ближний: ближнему ближний ближнем ближнего
бакалавриат: бакалавриата
приглашение: приглашение
ассоциация: ассоциацией
намного: намного
советчик: советчиком
сиполс: сиполс
ия: ии
слишком: слишком
ocr-слой: ocr-слой
ресурс: ресурсов
извечно: извечно
модный: модное
канд: канд
модернизация: модернизацию модернизация
появляться: появляются
служба: службе
мелкий: мелких мелкий
ава: ав
содержание: содержание
модернизационный: модернизационный
учение: учений
я: мной я мне меня
собирать: собираю
образ: образов образе образом образа
нефтедобыча: нефтедобычи
рядом: рядом
изображение: изображение изображением изображений
министерство: министерства министерством министерство министерств
объект: объекты
копейка: копейки копеек
колония: колоний
греческий: греческий греческого
воспитательный: воспитательное
совсем: совсем
переулок: переулок
делопроизводитель: делопроизводителю
ближневосточный: ближневосточной ближневосточная
джон: джон
русистика: русистика
сенатский: сенатский
бизнес: бизнес бизнеса
субъективный: субъективные субъективная
н: н
благодарность: благодарность
уолл-стрит: уолл-стрит
свобода: свободы свободу
август: августа
претендовать: претендую претендующих
помещение: помещения
максимизация: максимизацию
эпоха: эпохи
капит: капита
звучный: звучными
симбуна: симбун
расход: расходы
клюква: клюкву
самопиар: самопиара
уильям: уильям уильяма
поведение: поведении поведения
снести: снести
предъявить: предъявлено
различаться: различаются
внешний: внешней внешние
стремительный: стремительная
шестопаловый: шестопаловым
сообщать: сообщать
грузия: грузии
мой: моей мой мое мои мою
албания: албании
согласиться: согласиться
воспроизводство: воспроизводства
беспрецедентный: беспрецедентной
кинодраматургия: кинодраматургии
рл: рл
два: два две двух
сознавать: сознаю
обсуждение: обсуждениями
капитал: капитала капитал капиталы капиталов
перестать: перестать
психологический: психологических
режим: режима режиме режим
крен: крена
маршалл: маршалл
омега: омега
сталинистский: сталинистский
глобальный: глобальные
лимон: лимоном
стенд: стенд
плакун: плакунов
трудовой: трудового трудовой
исследовательский: исследовательским исследовательском
пребывание: пребывания
налепин: налепина
сибирь: сибирь сибири
инструкция: инструкцию инструкция
честно: честно
жж: жж
прямо: прямо
райцентр: райцентр
европейский: европейских
французский: французской французскую французская французских французского
мордовия: мордовия мордовии
употреблять: употребляя
успешный: успешное успешным успешного
свободно: свободно
явление: явления явлений
хрящ: хрящи
ничего: ничего
спешить: спеши
обрести: обрели
ольга: ольги ольга
сочинение: сочинение сочинения
степень: степени
восстановление: восстановление
немаловажный: немаловажную
ночник: ночника
начало: начале начала начало
ц: ц
историзм: историзма
белорусский: белорусской белорусский
позавчера: позавчера
восприятие: восприятия
зафиксировать: зафиксировать
паук: паук
демократический: демократический демократического демократические демократической
следствие: следствия
зарплата: зарплату зарплаты
нюрнбергский: нюрнбергский нюрнбергском
невозможный: невозможны
планово-экономический: планово-экономических
централизованно: централизованно
неестественный: неестественных
философский: философских философские
следовать: следует
автор: автору автор авторов автора авторы
nilskynikolay: nilskynikolay
россиюшка: россиюшке
почитать: почитать
свидетель: свидетелем
машина: машины
шовинизм: шовинизма шовинизм
круг: круга круг кругов кругу круги
подлинно: подлинно
любим: любим
по-большевистски: по-большевистски
ввести: введено
отмасштабировать: отмасштабировано
сегодняшний: сегодняшних сегодняшнему
гость: гостях гостей гости
прикрутить: прикрутил
устойчивый: устойчивого устойчивые
цель: целей целью цели целях
правосудие: правосудия
гарантировать: гарантирую
бутылка: бутылка
полноценный: полноценный
чиновник: чиновник чиновников
чикагский: чикагского
бюджет: бюджетом бюджет
потерять: потеряла
транспорт: транспорте транспорта транспорт
europaea: europaea
аудитория: аудитория аудитории аудиторию
догнать: догнать
свежий: свежее
нюрнберг: нюрнберге
хрестоматия: хрестоматия
гу: гу
краткий: кратком краткого
воздушный: воздушного воздушный
юридический: юридической
держать: держал держала
сталинизм: сталинизма сталинизм
деятельность: деятельности деятельность деятельностью
идеальный: идеальных идеальные
огрубение: огрубению
рефлексивность: рефлексивности
фотограф-постмодернист: фотографа-постмодерниста
жуков: жуков
вклад: вклад вкладе вклада
тост: тостов
одинаковыевсе: одинаковыевсе
опровержение: опровержением
детство: детства
город: город
противостоящий: противостоящем
журналистка: журналистка
империалист: империалистов
долгосрочный: долгосрочного
спрятать: спрятал
существо: существу
политик: политик
командир: командиры
кое-что: кое-что
сборник: сборник сборником сборнике сборнику сборники сборника
гестапо: гестапо
разряд: разряду
обнаружить: обнаружил
китайский: китайских китайские китайского китайский китайской китайскую
явно: явно
передать: передали
дискурс: дискурсов дискурсы
плюс: плюсов
туган-барановский: туган-барановского туган-барановский
закабаление: закабалении
летать: летать
япония: японией япония японии
формулироваться: формулируются
тестирование: тестирование
как-то: как-то
пропаганда: пропаганду
орда: орду
сценарист: сценарист
утверждать: утверждаю
проектирование: проектирования
реклама: рекламе рекламы рекламой
минувший: минувших
лишение: лишения
наблюдатель: наблюдателя
облечённый: облеченным
промышленный: промышленного промышленных промышленные промышленный
закончить: закончившего закончили
внедрение: внедрения
очередной: очередного очередной
юрист: юристов
представляться: представляется
международный: международных международной международная международные международным международном международного международный
молдавия: молдавии
капитанский: капитанской
победоносный: победоносная
звание: звание
рассусоливать: рассусоливать
мвломоносов: мвломоносова
рязанско-козловский: рязанско-козловской
представлять: представляю представляют представляет
фарид: фарида фарид
николай: николай николая
начальный: начальный
яичный: яичный
южный: южного
нихер: нихера
fhusainov: fhusainov
хорн: хорн
вернуться: вернулись вернуться вернемся вернулся
рекомендоваться: рекомендуется
лазаревский: лазаревском
картина: картину
вульгаризировать: вульгаризированного
постоянно: постоянно
идеал: идеалам
проходить: проходит проходят
байбак: байбаков
какой-нибудь: какую-нибудь какой-нибудь какое-нибудь
взглянуть: взглянуть
заметно: заметно
замок: замок
какой-никакой: какой-никакой
соль: солей
сразу: сразу
важно: важно
увозить: увозили
повторять: повторять
понять: понять понял
влиятельный: влиятельных
десять: десять
настроить: настроенные настроено
здоровенный: здоровенный
пить: пить
программно-целевой: программно-целевого
using: using
аналитический: аналитическая
объяснение: объяснением объяснение
направить: направлены направленных
перевозка: перевозку перевозок перевозки
перемена: перемены
рв: рв
героический: героической
инструмент: инструментом
упорный: упорнее упорных
похлеще: похлеще
монография: монографии монография
квартира: квартира
спафария: спафарий спафария
л: л
страновой: страновым
сладковский: сладковского
дьявол: дьявола
питер: питер
пустырь: пустырь
доставать: достает
пизда: пизде
наблюдать: наблюдать
колбаса: колбасу колбаса
мясной: мясные
выкрик: выкриков
проектный: проектных
академия: академия академии
термидор: термидора
отношение: отношение отношения отношении отношений
суверенитет: суверенитета суверенитет
конспектирование: конспектирования
простить: простите
двигать: двигать
страстно: страстно
подрывать: подрывает
сажать: сажать
практически: практически
сергеев: сергеева
недостаточно: недостаточно
особенно: особенно
издержка: издержек издержки
урьяс: урьяса
приурочить: приурочено
различный: различные различных
прикладывать: прикладывал
католический: католической
видный: видного
андраш: андраш
движущий: движущие
адресовать: адресована
противостоять: противостоять
мао: мао
больной: больными
коммунистический: коммунистических коммунистическая коммунистической коммунистического
медведев: медведев медведева
ощутимый: ощутимым
тогда: тогда
руководитель—доктор: руководитель—доктор
мрак: мрак
обоснование: обоснование обоснования
тадам: тадам
ст: ст
черпак: черпаков
василий: василия
житель: жителям
совершенный: совершенных
развивать: развивали
водород: водорода
цена: ценам цены цене цен
молдавский: молдавский молдавского
полнота: полнотой
более: более
пробел: пробел пробела
поддать: подданными
создавать: создавать
осмысление: осмысления
медведково: медведкова
эмиграция: эмиграции эмиграция эмиграцию
осуществление: осуществлением
востоковедение: востоковедения
подтянуть: подтянули
стакан: стакан
значение: значения значение значении
целевой: целевая
солнышек: солнышков
индустриальный: индустриальное индустриального
приличие: приличий
оборона: обороны
жи: жи
груз: грузов
результат: результатом результатов результат результата результаты результате
сущность: сущности сущность
хотеться: хочется хотелось
ведущий: ведущей
лечить: лечить
идиот: идиоты
целое: целом
влететь: влетел
приём: приемам
диссертация: диссертации
почитать-ка: почитаю-ка
обезьяна: обезьяны
черномордик: черномордик
увеличиться: увеличились
вспомнить: вспомнить вспомнил
примерно: примерно
жаловаться: жаловались жаловаться
классик: классиков классиками
критика: критике критика
щёлочь: щёлочь
нереализуемость: нереализуемости
трумэн: трумэном
высота: высоты высоту
национализм: национализма национализм
девяностый: девяностых
переть: прёт
вода: воду
кровавый: кровавых кровавый кровавого
разделение: разделение
концептуальный: концептуальный
насильственный: насильственной насильственная
заключаться: заключается заключалась
профсоюз: профсоюзов
аргумент: аргумент
воодушевить: воодушевили
приличный: приличный приличной
знание: знаний знания знание
будда: будда
объясняться: объясняется
социально-политический: социально-политическими
устанавливаться: устанавливается
пещера: пещерах пещеры
вериться: верится
редакция: редакцией редакция редакции
переводить: переводили переводил
трудно: трудно
юс: юс
либерал: либерал либералы
ноздря: ноздре
поле: поле
пожизненный: пожизненного
демо-версия: демо-версию
эксплуатационный: эксплуатационная эксплуатационной
хорошо: хорошо
сорт: сорта
сходный: сходной
оптовик: оптовики
миллион: миллиона миллионам
популярность: популярность популярностью
потребность: потребность
действовать: действовал действует
встречать: встречали
итог: итоги итогам итоге
информатизация: информатизацию
обойтись: обойтись
лизм: лизма
специализация: специализацией
операция: операции
открываться: открывающуюся
многокритеальный: многокритеальных
торнадо: торнадо
внимательный: внимательного внимательном
уже: уже
сравнивать: сравнивать
доктор: доктор доктора
давать: давать дают дает
адвокат: адвокатов
директор: директоров
оружейный: оружейного
стройный: стройные
действительно: действительно
тк: тк
кольцо-то: кольца-то
картель: картеля
ниокр: ниокр
прогноз: прогнозами
ржд: ржд
руководствоваться: руководствовался
конец-край: конца-края
ноу-хау: ноу-хау
лектор-международник: лекторов-международников
импорт: импорта
проверить: проверенные проверенных
действительность: действительности
согласный: согласен
медицина: медицины медициной
множество: множества
событие: событиях события событиям событий
габордюг: габордюгов
вердикт: вердикта
америка: америки америке
невыносимый: невыносимого
антимарксистский: антимарксистская антимарксистский
потребление: потребления
прогрессивный: прогрессивных прогрессивную
профиль: профилем
проталкивать: проталкивали
судебный: судебный
единоличный: единоличной
ознакомиться: ознакомится ознакомиться
публичный: публичные
тс: тс
землячка: землячке землячки землячку
кеннеди: кеннеди
харламов: харламов
неминуемо: неминуемо
коллектив: коллективом коллективами
пушкин: пушкин
эффект: эффект
прочитать: прочитал
бросать: бросать
книжка: книжки книжка книжку
нехватка: нехватки нехватка
говно: говно
настоять: настояла
формировать: формируя
положить: положенным
кафедра: кафедра
аспирант: аспирантов
проведение: проведения
№№: №№
фидбек: фидбек
действительный: действительными
меньшинство: меньшинств
фрактальный: фрактальных
ухудшать: ухудшая
фулбрайт: фулбрайтом фулбрайта фулбрайтов фулбрайт фулбрайте
поход: походов похода
нии: нии
худлить: худлит
лично: лично
закрыть: закрыло закрыть
распад: распаду
—август: —август
плохо: плохо
монополистический: монополистической монополистический
ж-ф: ж-ф
милейковский: милейковского
ощущаться: ощущается
фашистско-хортистский: фашистско-хортистским
наказуемый: наказуемые
паразитировать: паразитировать
индивидуальный: индивидуальное индивидуальной
вековой: вековых
подчинённый: подчиненную
сжимать: сжимал
картелирование: картелированием
надоесть: надоело
отличать: отличало
правительственный: правительственных
с-петербургский: с-петербургского
openid: openid
фоменко: фоменко
рассчитать: рассчитана рассчитано
род: рода
разрешение: разрешение
миф: миф мифы
хрущёв: хрущев хрущёв
цифра: цифры
вэ: вэ
отличаться: отличаются
призывать: призывать
перевернуться: перевернулся
даваться: даются дается
зарубежье: зарубежье
русско-молдавский: русско-молдавских
составление: составление
остальной: остальные
правовой: правовая
указатель: указателе
истребитель: истребителей
планшет: планшетом
научно-исследовательский: научно-исследовательский научно-исследовательских
хозяйственный: хозяйственного хозяйственной хозяйственных
запись: записей записи
натравить: натравить
мгу: мгу
лекция: лекций лекция лекции
взяться: взялся взяться
можно: можно
исправить: исправленное
трудоустройство: трудоустройства
бомбардировщик: бомбардировщика
описание: описанию
карьера: карьеру
топление: топлении
моб: моб
страшно: страшно
лаос: лаос
заинтересоваться: заинтересуется
оно: оно
организм: организма
техногенный: техногенной
свадебный: свадебной
соискание: соискание
совершить: совершил
нкпс: нкпс
фундаментальный: фундаментальной фундаментального фундаментальный
ток: током
отлично: отлично
николаев: николаева
чепрак: чепраков
госуправление: госуправления
говнистый: говнистее
оказаться: окажется оказалось оказался оказались оказалась
сформулировать: сформулировать
xii: xii
перес: перес
соавтор: соавтор
иса: ис
заслуга: заслуга
создать: созданы
анархический: анархическая
зверь: зверем
утверждение: утверждение утверждения
мак-дональд: мак-дональд
эльфийски: эльфийски
пономаренко: пономаренко
центр: центр центрах центре центром центров центры
выставить: выставили
наиболее: наиболее
файл: файл файла
пересобрать: пересобрал
вписать: вписал
парцилляция: парцилляция
знамя: знамени
соперничество: соперничества
синтез: синтез
методика: методика
аргументация: аргументацию
мпс: мпс
давно: давно
оттачивать: оттачивали
могилевкин: могилевкин
свидетельствовать: свидетельствуют
альфред: альфред
истинный: истинное истинном истинных
рефлексировать: рефлексируют
касаться: касающаяся касающихся
вятский: вятский
хвост: хвостов
час: час
молодой: молодая молодого
далеко: далеко
подвергать: подвергает
достоинство: достоинства
поступить: поступил
развал: развала
югославия: югославии
большинство: большинство большинства
вечерний: вечерней
двор: двором дворе
картиночка: картиночки
заметка: заметки
забыть: забыли забыть
разоблачаться: разоблачается
недоумевать: недоумевал
пара: пары паре
государственно-монополистический: государственно-монополистического
comment: comment
попробовать: попробовать
возможность: возможность возможности
хлебозаготовительный: хлебозаготовительная
правительственно-политический: правительственно-политических
обидеться: обидевшись
трибунал: трибунала
вермахт: вермахта
родина: родина
пр: пр
современность: современности современность
практика: практики
фалин: фалин
дальнейший: дальнейшего
печатный: печатных
справиться: справился
слой: слой слоя
раздробленность: раздробленности раздробленность
лекционный: лекционных
мавродина: мавродин
интерпретация: интерпретации интерпретациям
предприятие: предприятий
режиссёр: режиссер режиссера
издание: издание издания
косой: косого
заключение: заключение
сельхозпродукция: сельхозпродукцию
стоимость: стоимости
полуостров: полуострова
учитель: учителей
литература: литература литературе литературы
задний: задним
оккупировать: оккупированной
выполнить: выполнены
отвечать: отвечают
наряду: наряду
социализм: социализмом социализм социализма
экзамен: экзамен
одинаково: одинаково
жить: живут жила жил
разбитый: разбит
естественный: естественном естественный
мизерный: мизерным
типография: типография
twirpx: twirpx
верить: верит
зловещий: зловещая
крах: краха
общественно-исторический: общественно-исторические
правый: правой
анализироваться: анализируются
миниатюра: миниатюре
козлов: козлова козлов
серьёзный: серьезные
выкладывать: выкладывать выкладываю выкладывал
ранний: раньше
гранберг: гранберга
питьевой: питьевых
назад: назад
обозреватель: обозреватель
посредственный: посредственный
личный: личная личные личный личной личного
выдающийся: выдающийся выдающихся
оцифровка: оцифровки оцифровка
успешно: успешно
одиночество: одиночестве
асср: асср
пс: пс
исправлять: исправляем
заявить: заявил
задумать: задумал
сериал: сериал
проклятый: проклятые
репрессия: репрессии
затрата: затраты затрат
николаевич: николаевич
рыночный: рыночным рыночные
транснациональный: транснациональных
участие: участию участия
внимание: внимание внимания вниманию
ландо: ландо
подменяться: подменяется
преувеличение: преувеличением
притча: притча
неоколониалистский: неоколониалистской
волей-неволей: волей-неволей
соседний: соседних
херня: херни
studia: studia
бой: боям
спасаться: спасаться
планироваться: планировалась
уверенный: уверен
неплохой: неплохое
заполнить: заполнены
характер: характер характера характерами
поощрять: поощряло
спонтанно: спонтанно
эмоциональный: эмоциональных
проехать: проехали
быстров: быстрова
экологический: экологическую
комплекс: комплексе комплекса
выпускной: выпускного
видение: видение видением
originally: originally
потреблять: потребляемого
милеска: милеску
захапать: захапает
сюманить: сюманите
столетие: столетия
закономерность: закономерностях
потребовать-таки: потребовали-таки
старое: старого
райт: райт райта
непосредственный: непосредственного непосредственных
совокупность: совокупность
ценообразование: ценообразования ценообразованию ценообразование
гораздо: гораздо
биология: биология
класть: клал
программный: программных
турецкий: турецкого
партизан: партизан
мореходство: мореходства
содержаться: содержится содержатся
становиться: становится
игра: игрой игры игра
воевода: воевода
много: много
впервые: впервые
дневниковый: дневниковые
рузвельт: рузвельтом
начинаться: начинается
предпринимательский: предпринимательской
показатель: показатели показателя
подборочка: подборочку
итоговый: итогового
высказывание: высказываний
любитель: любителей любителем
поучаствовать: поучаствовать
предназначить: предназначено предназначена
народно-демократический: народно-демократическую
раскольнический: раскольнического раскольническая
решиться: решился
ужасный: ужасный
справочник: справочник
перспектива: перспективы
маркс: маркса
третьяков: третьяковой
р: р
причёска-то: причёску-то
ноунейм: ноунейма
спрашивать: спрашивали
радостно: радостно
закрытый: закрыт
воссоздать: воссоздав
составитель: составитель
формироваться: формировалась
теоретико-игровой: теоретико-игровой
ход: ход
иноземец: иноземцев
рулевой: рулевые
ботаник: ботаник
политика: политику политика политики политике
гостиница: гостиницу
энциклопедия: энциклопедия
рисовать: рисуют
моноэтнический: моноэтническим
следующий: следующем следующий
райзберг: райзберг райзберга
вестись: ведется ведутся
вельский: вельского
изменение: изменения изменением изменение
бывший: бывшим
резкий: резкий
спокойствие: спокойствие
догонять: догоняющего
безопасность: безопасности
чёртеть: чёрти
ожидание: ожидания
продать: продать
состоять: состоят состояла
назначать: назначаемых
независимый: независимых
физика: физика
сесть: сел
бежать: бегут
постепенно: постепенно
запостить: запостить
ил: ил
акт: актом акт
петропавловский: петропавловская
влезать: влезал
неплохо: неплохо
специальный: специальный специального
услышать: услышать услышал услышали
подвижка: подвижка
перечень: перечень
научно-технический: научно-технической
размер: размер
никто: никто никому
снова: снова
нехорошо: нехорошо
осуществлять: осуществлять
градация: градациях
атташе: атташе
чураться: чураемся
услуга: услуга
дополнить: дополненное
всплеск: всплеск
миронов: миронов
фольклор: фольклор
потеря: потерь
посадить: посадили
коммунизм: коммунизме коммунизм
форма: формы форм
империализм: империализмом империализма империализм
чистый: чистая
отравление: отравлений
километр: километров
испанский: испанского
качественный: качественных
зародиться: зародилось
господство: господство
упорно: упорно
украйна: украйной
значимость: значимости
биологический: биологических
однозначно: однозначно
проливать: проливают
нк: нк
случаем: случаем
ps: ps
контекст: контекст
угодный: угодно
корягин: корягин
воспринимать: воспринимала воспринимают воспринимали
предел: пределами
ум: умы
ютуба: ютубе
введение: введение
воспитываться: воспитывалась
леонтьевский: леонтьевский
жрать: жрать
кристиан: кристиан
наглядно: наглядно
академгородок: академгородке
марксизм-ленинизм: марксизма-ленинизма
география: географию география
снег: снег снега
рост: роста рост
аспект: аспекты
разобраться: разобраться
исключение: исключение
полностью: полностью
супер-спам-серия: супер-спам-серия
единомышенник: единомышенников
отдельно: отдельно
эдакий: эдакий
бисер: бисер
академический: академическую академическими
принадлежать: принадлежит
завоевание: завоевания
добавить: добавлен добавил
смениться: сменилось
верный: верна
чрезвычайно: чрезвычайно
досадный: досадный
куликов: куликов
обобщать: обобщает
базис: базиса
только: только
этап: этапах этапе этап
djvu: djvu
подробность: подробностей
сорвать: сорвать
камера: камеру
наверняка: наверняка
сводка: сводка
рельсовый: рельсовых рельсовым
ран: ран
природа: природу
анекдот: анекдот
излагаться: излагаются
защита: защиту
xviii-xix: xviii-xix
узнавать: узнаю
недавно: недавно
интересно: интересно
сканирование: сканированию
иван: ивана иван
экскурс: экскурс
ветер: ветер
делить: делила
собраться: собрались соберусь
марка: марок марки
захват: захвате
эрнесто: эрнесто
скука: скуки
рен: рене
га: га
формат: формат
легитимизация: легитимизации
просоциалистистически: просоциалистистически
остаться: осталось останется
кто-то: кто-то
объяснялка: объяснялка
кто: кем кого кому кто
открыться: открывшаяся
системный: системный системного
мотив: мотивы
многие: многие
ниу: ниу
семь: семь
кровообращение: кровообращения
налить: налил
товар: товары
президент: президентами президента
ханойский: ханойского
опять: опять
обвинение: обвинение обвинению
сканер: сканер
газетный: газетной
сосредотачиваться: сосредотачиваются
отфотографировать: отфотографировать
цзэ-дун: цзэ-дуна
тяготеть: тяготеют
нормально: нормально
оригинальный: оригинальным
дно: дно
средство: средств средства
детектив: детектива
реально: реально
грузовой: грузовых грузовая грузового
напомнить: напомнить
бокал: бокал
кембриджский: кембриджской
защитительный: защитительные
фактическиерезультат: фактическиерезультаты
старый: старые старом
азия: азии
научпоп: научпоп
вашингтон: вашингтона вашингтоне
затем: затем
исходник: исходник
задать: заданными
жан-франсуа: жан-франсуа
продукт: продуктов
австрийский: австрийские
популярный: популярная
минус: минусами
проложение: проложению
способ: способы способ
требование: требования требованиями
работник: работников работники
настолько: настолько
тело: тело
скорый: скорого
запад: запада запад
разрыв: разрыв разрывом
избегать: избегайте
показаца: показаца
болезненно: болезненно
ведута: ведута
говориться: говорится
развалиться: развалился
изучить: изучить
урожай: урожай
лукавство: лукавство
хватать: хватает
придираться: придираться
сотрудничество: сотрудничество сотрудничеству сотрудничества
прочесть: прочёл прочел
конструкция: конструкция
неэффективность: неэффективности
постановка: постановки
сегодня: сегодня
освобождение: освобождения
математик: математика
уходить: уходят
иначе: иначе
надеяться: надеюсь
момент: моменты момента момент
was: was
терри: терри
ввп: ввп
болтология: болтологии
племянник: племянника
воцарение: воцарением
геноцид: геноцида
моторс: моторс
ларрасабаль: ларрасабаль
легитимность: легитимности
приблизить: приближенных
ипостась: ипостаси
образность: образностью
замысел: замысел
лорианом: лорианом
иногда: иногда
беженец: беженцев
хуйня: хуйне
антисоветский: антисоветских
удосужиться: удосужилась
малое: малого
столперо: столпера
альфа: альфа
питьё: питьём
клиометрический: клиометрическая
худенький: худенькие
сознательный: сознательного
переделать: переделал
бурлацкий: бурлацкий бурлацкого
драматический: драматических
макрорегион: макрорегионов
makulaturoman: makulaturoman
гектар: гектар
средненький: средненькая
публицист: публицист
абстрактный: абстрактные
шишов: шишова
укрепление: укрепление
цвести: цветут
что-то: чего-то что-то
ермаков: ермаков
программа: программы программ программе программой программу программа
вписываться: вписываюсь
фролов: фролов фроловой
жданов: жданова
каяться: каюсь
коэффициент: коэффициентов
фашизм: фашизма фашизм
член: членом
рибера: рибер
смочь: смог сможет
путешественник: путешественник
кривой: криво
добавлять: добавлять добавляют
начинать: начиная начинаем
выявить: выявить
географ: географ
phd: phd
помнить: помнишь помню
признанный: признанная
судить: судить судя
рэш: рэш
курсовой: курсовую
мужик: мужик
утверждаться: утверждается
ракетно-ядерный: ракетно-ядерных
духовный: духовного
лженаука: лженаукой
националист: националистов
обстоятельство: обстоятельствах
милитарист: милитаристов
калинин: калинина
собрание: собрания собранию
пониматься: понимается
рукомойник: рукомойником
вспышка: вспышку
обобщённый: обобщен
насильно: насильно
активный: активный активной активное
рационально: рационально
аба: аб
фонтан: фонтаном
покатиться: покатился
зачем: зачем
фридман: фридмана
далее: д
предыдущий: предыдущее предыдущих
матрица: матрице
встраивать: встраивать
напряжённость: напряженности
улавливать: улавливаемым
галерея: галерея
ф: ф
среднее: среднего среднем
американо-китайский: американо-китайских
стивен: стивен
держава: державами державы
немецкий: немецкого
красочный: красочные
чуть: чуть
чжун-хуан: чжун-хуан
масса: масса массе массой массы
противиться: противиться
вчерашний: вчерашнего
спрос: спроса
просрута: просрут
деяние: деяния
вариант: вариант вариантов
леонтьев: леонтьева
литератор: литераторы литераторов
запоминать: запоминает
вставка: вставки
разрешить: разрешено
нагнетать: нагнетает
апологетика: апологетики
отделение: отделение
славянин: славян
сверхузкий: сверхузкую
выглядеть: выглядел выглядит
предприниматель: предпринимателей
фрик: фриков
трешак: трешак
темп: темпы темпам
спешка: спешке
гражданин: гражданами
веха: вехи
девушка: девушки
тирания: тирании
искать: искал ищут
обоснованность: обоснованность
доводиться: доводится
конкурентоспособность: конкурентоспособность
вывести: вывела
спохватиться: спохватились
колупаться: колупался
предельный: предельной
пагубный: пагубное пагубным
перегрузочный: перегрузочные
беженство: беженства
войти: вошла
xvii: xvii
воспринять: воспринять
фрг: фрг
вмещать: вмещали
море: море
марксистка: марксисткой
временно: временно
указать: указать
самонадеянность: самонадеянность
джоравски: джоравски
побеседовать: побеседовать
восемь: восемь
сиять: сияющее
начаться: начался
критерий: критерия критерий
изнутри: изнутри
сверхприбыль: сверхприбылью
вводиться: вводилось
портрет: портрет
апрельский: апрельской
сиё: сиё
референция: референцию
меняться: меняющихся
сколько: сколько
квадрат: квадрате
прогресс: прогресса прогресс
специалист-географ: специалистов-географов
конспирология: конспирология
архивный: архивных архивные
битва: битвы
запомнить: запомнили
потому: потому
закислении: закислении
обособленность: обособленность
обеспечить: обеспечить
политэкономия: политэкономии
специя: специи
двадцать: двадцати
смесь: смесь
включать: включающих
ораторский: ораторского
озвучить: озвученные
карта: карта
пиджачок: пиджачке
немой: нем
соприкасаться: соприкасаюсь
городской: городского городской
гарвардский: гарвардского
смело: смело
закисление: закисления закисление
балабан: балабанов
развитой: развитых
повышение: повышения
политизировать: политизирована
конференция: конференциях конференции
отводиться: отводится
сахаров: сахарова
драгоценный: драгоценные
умереть: умрут
каменский: каменский
болгария: болгарии
надо: надо
её: её
атрибутика: атрибутики атрибутику
прослеживать: прослеживать прослеживают
вакозлов: вакозлов
обсуждать: обсуждать
чреда: чреде
гецов: гецова
решить: решены решило
подразделение: подразделений
профессиональный: профессиональный профессиональной
иванович: ивановича
детективный: детективной
дб: дб
ля: ля
оригинальность: оригинальность
медпросвет: медпросвет
экшн: экшн
исследуться: исследуется исследуются
размножаться: размножаются
авиационный: авиационный
послесловие: послесловие
обзавестись: обзавелись
балканский: балканских
точка: точки
выбрать: выбрал выбрала
кадровик: кадровиков
соотношение: соотношения
джп: джп
электричка: электричке
юрий: юрий
корочка: корочку
сравнительный: сравнительном сравнительного
лесообрабатывающий: лесообрабатывающую
эг: эг
ввергнуть: ввергнутым
картить: картя
искусственно: искусственно
отвергнуть: отвергнута
поблагодарить: поблагодарил
клан: клан
вызвать: вызванный
математический: математических
занимательный: занимательной
сдвиг: сдвиги
непрактичный: непрактичными
стратегический: стратегических
сосредоточить: сосредоточив
почему-то: почему-то
канё: канё
злодеяние: злодеяниях
удаваться: удаются
цензура: цензура
обслуживать: обслуживает
мгушный: мгушный
прочный: прочного
клиометрист: клиометриста
обучение: обучение
кадр: кадром
стиль: стиле
пока: пока
островский: островский
шейла: шейла
открывать: открывая
минтранс: минтранса
весить: весят
via: via
ва: ва
орать: орут
герварт: герварт
спасть: спал
телефон: телефоном
местность: местности
электролит: электролиты
количество: количество
производитель: производители
престол: престолов
триллер: триллера
секретарь: секретарей
анкетный: анкетных
риффо: риффо
iii: iii
правящий: правящие
почистить: почистил
сведение: сведения
лицо: лиц
выездной: выездной
самара: самара
социализация: социализация
необработанный: необработанных
историография: историографии
эстетика: эстетика
молчаливо: молчаливо
ввс: ввс
известно: известно
убывать: убывающая
утихнуть: утихли
экономико-математический: экономико-математических
переломный: переломного
бордюг: бордюгов
вообще: вообще
объяснить: объяснить
нормативный: нормативное
авторитарный: авторитарной
экология: экологией
поздно: поздно
использоваться: использоваться
катиться: катится
layer: layer
комитет: комитет комитетом
супер-серия: супер-серию
кислота: кислота кислоту
трезвенник-язвенник: трезвенниками-язвенниками
необрезанный: необрезанный
заглавие: заглавии
поток: потоком
официально: официально
проработать: проработал
индустриализация: индустриализации индустриализация
призма: призму
очки: очках
неведомый: неведомой
данный: данную
занизить: заниженным
китаеведческий: китаеведческие
майкл: майкл
литовец: литовцев
выпускник: выпускника
многочасовой: многочасовые
афоризм: афоризмов
ранжировать: ранжировать
воображение: воображения
похвалить: похвалите
кинематографический: кинематографическое
двое: двоих
прошедшее: прошедшие
попросить: попросить
валютно-финансовый: валютно-финансовым
рапон: рапоне
затратить: затраченных
оплата: оплаты
выдержать: выдержал выдержанные
специальность: специальностей специальности
нм: нм
основополагающий: основополагающим
совместно: совместно
регулирование: регулирования
письмо: письма письмо
шаульский: шаульский
освещение: освещение освещению
связать: связано
отдаваться: отдавалось
кино: кино
вложить: вложило
межотраслевой: межотраслевого
индивидуализация: индивидуализации
сырьё: сырья
париж: париже
фолиант: фолиант
неделя: неделю
агрессорровый: агрессорров
украдкой: украдкой
принимать: принимать
поэтому: поэтому
vas-s-aldreamwidthorg: vas-s-aldreamwidthorg
милль: милля милль
советско-китайский: советско-китайскому
критик: критиков
судоходный: судоходной
раскол: расколу
вьетнам: вьетнама
козеллек: козеллека
дэвид-фокс: дэвид-фокс
обработка: обработке обработку
открыто: открыто
сжатие: сжатия
хлопоты: хлопот
смерч: смерч
https: https
пресса: прессе
наглядность: наглядностью
конечный: конечного
копать: копать
заодно: заодно
считаться: считаться
сокрушительный: сокрушительный
гузнер: гузнер
омут: омут
слезиться: слезятся
ага: аг
гордость: гордостью
юрлитинформ: юрлитинформ
политиздата: политиздат
кальций: кальция
фонд: фонд
страбон: страбон страбона
саратовский: саратовской
приносить: приносят
усталый: усталой
бернштейн-коган: бернштейн-коганом
древнегреческий: древнегреческий
немало: немало
штиинец: штиинца
полугодие: полугодии
изделие: изделия
эйзенхауэр: эйзенхауэром
нарушать: нарушать
достойный: достоин
ключ: ключе
незыблемый: незыблемый
вагон: вагонов
собираться: собирался
карстовый: карстовые карстовых
сосиска: сосиски сосисок
буарон: буарона
заголовок: заголовках
вырастить: вырастили
присваивать: присваивали
милый: милее
кесслера: кесслер
смотреть: смотреть
бергер: бергер
актуализация: актуализация
частность: частности
отсканировать: отсканировать
интернет-юзер: интернет-юзеров
умонастроение: умонастроениях
реальность: реальность
толкать: толкают
семинар: семинар
вольный: волен
характеристика: характеристика характеристики
анцэ: анцэа
анализировать: анализирует
первоисточник: первоисточником
опять-таки: опять-таки
тянуть: тянет
основывать: основывали
искренне: искренне
мимоходом: мимоходом
почти: почти
выложить: выложил
сражение: сражения
проанализировать: проанализировать
учёба: учёбой учеба
светиться: светятся
четверть: четверть
гениальный: гениальный
устройство: устройства
маоист: маоистов
выгода: выгоду
катерина: катерина
вряд: вряд
внутрипроизводственный: внутрипроизводственный
дискуссия: дискуссии
длительность: длительности
ответить: ответить
прошлый: прошлый
шишовой: шишовой
инстинктивный: инстинктивного
удивление: удивление удивлением
точно: точно
наследница: наследница
типичный: типичный
тд: тд
копосова: копосова
задыхаться: задыхаешься
условно: условно
идеолог: идеологом
откопать: откопал
функционирование: функционирования
др: др
девять: девять
припоминать: припоминают
солнце: солнце
привыкать: привыкаешь
воспитание: воспитания
повестка: повестку
шлейф: шлейф
бм: бм
более-менее: более-менее
пи: пи
террор: террор
пинать: пинать
шнипер: шнипер
нсдап: нсдап
вдруг: вдруг
производство: производства
сумма: сумме
постсоветский: постсоветского
агрессор: агрессорам
подготовка: подготовкой
приводиться: приводятся
толкнуть: толкнуло
такой-то: такой-то таком-то
способный: способны
обширный: обширном обширный
интервью: интервью
патриот: патриоты
содружество: содружестве
приоритет: приоритетов
могущественный: могущественный могущественному
зорин: зорина
мочилово: мочилово
насилие: насилие
ковалевский: ковалевский
имэмо: имэмо
сторонник: сторонников
ориентировать: ориентирован
автомобилестроение: автомобилестроения
погибнуть: погиб
d: d
преследовать: преследует
лихой: лихая
розан: розанов
украинский: украинской
определить: определить
заслуживать: заслуживает
охватывать: охватывающим
конец: конце конца
xxvii: xxvii
вовлекать: вовлекает
сходить: сходите
совершенно: совершенно
сергей: сергей
легенда: легендах
аллегория: аллегории
женидьба: женидьбу
кайф: кайф
апрель: апреля
творческий: творческом
оказывать: оказывает
умалатов: умалатова
сырой: сырыми
фотография: фотографии
рф: рф
бажанов: бажанова
сговариваться: сговариваясь
пренебрегать: пренебрегают
цитата: цитата
отчасти: отчасти
мусор: мусор
популяризатор: популяризаторам
грань: грань
коммунальный: коммунальная
разговор: разговор
лево-демократический: лево-демократический
враг: враги врагов
бабло: бабла бабло
редколлегия: редколлегия
методология: методологию методологии
агрессивный: агрессивных агрессивной
призвание: призванию
сова: сов
пищать: пищит
грамотно: грамотно
рассуждать: рассуждают
обходить: обходила
главное: главное
образовать: образован
антиимпериалистический: антиимпериалистический
опрокинуть: опрокинул
братский: братских
похожий: похожих
отсталость: отсталости
преемственность: преемственность
поддержка: поддержки
эксплуатация: эксплуатации
абсолютно: абсолютно
комментарий: комментарием
учитывать: учитывать
красота: красоты
историко-экономический: историко-экономический
территория: территории
взаимосвязь: взаимосвязь
сперанский: сперанский
публицистика: публицистику публицистика
прочно: прочно
эпичный: эпичнейший
научить: научил
характеризоваться: характеризуется
сугубо: сугубо
завербоваться: завербовался
фотографироваться: фотографировались
наталья: наталья
фамилия: фамилией
петрович: петрович петровича
поклёп: поклёпа
свитер: свитерах
кларк: кларк
ласточка: ласточке
пётр: петра
полтора: полторы
обвинить: обвиненных
реальный: реальная
радовать: радует
посмотреть: посмотрел посмотреть
понимание: понимания
продавить: продавил
совместить: совместить
временной: временных
творец: творца
тут: тут
защитник: защитников защитниками
футболка: футболку
добавка: добавки
критиковаться: критиковался
обустройство: обустройствам
душевный: душевное
переворот: переворот
мёд: мёдом
милитаризм: милитаризма
pdf: pdf
основание: основании
вложение: вложений
драма: драма
втуз: втузов
лысый: лысый
домой: домой
пробудить: пробудить
тяжело: тяжело
хрень: хренью
цикл: цикл циклов
взаимный: взаимной
занятой: занятых
неспокойный: неспокойном
подозревать: подозреваю
entry: entry
обслуга: обслуги
де-факто: де-факто
так: т
строй: строй
сидеть: сидят
аи: аи
победить: победит
долг: долгом
предметно: предметно
литературоведение: литературоведению
многочисленный: многочисленным многочисленного
менталитет: менталитет
уголовно: уголовно
лориана: лориана
мышление: мышления
старание: стараниями
дружба: дружбу
выполнять: выполнять
деревня: деревнях
голод: голода
забавно: забавно
грунт: грунта
коренной: коренные
здесь: здесь
румыния: румынии
сосредоточиваться: сосредоточивается
skaramush: skaramush
окружающий: окружающих
ню: ню
логично: логично
там: там
исправление: исправлении
решаться: решается
протяжение: протяжении
человеконенавистнический: человеконенавистнические
правильно: правильно
энергетический: энергетического
актуальный: актуальная актуальными
сопёс: сопсе
реализовать: реализовано
утопия: утопия
снабдить: снабжена
сост: сост
нищета: нищету нищеты
ермашева: ермашев
ми: ми
классовый: классовой
религиозный: религиозная
тарификация: тарификации
развлечение: развлечение
скучать: скучающий
купить: купил
легитимный: легитимна
сформироваться: сформировался
оттиск: оттиск
блок: блок
чуть-чуть: чуть-чуть
полномочный: полномочными
приварить: приварили
этнографический: этнографический
кардинал: кардинал
удивлённый: удивлён
отрекаться: отрекается
продолжить: продолжить
глубинный: глубинных
ворье: ворья
проводиться: проводившейся
пекарский: пекарский
захватчик: захватчиков
кн: кн
теорема: теоремы
открыть: открыть
телевидение: телевидения
доктрина: доктрину
передел: передел
оттуда: оттуда
нетипичный: нетипичная
коннотация: коннотаций
студент-биолог: студентам-биологам
всесторонне: всесторонне
манера: манере
деньга: деньги
гевар: гевары
большевистский: большевистского
пропустить: пропущен
нагнетание: нагнетания
иктп: иктп
пиздец: пиздец
кровь: крови
расселение: расселения
чисто: чисто
рекомендовать: рекомендовано
умилять: умиляет
rossica: rossica
избрать: избрали
выигрывать: выигрывает
подводить: подводя
руководитель: руководители
животное: животных
могучий: могучая
сдохнуть: сдохнут
псевдоним: псевдоним
монополии-враг: монополии-враги
правление: правления
громыко: громыко
молдовеняскэ: молдовеняскэ
заработок: заработки
полетаев: полетаева
обычно: обычно
беспомощно: беспомощно
уж: уж
тяжёлый: тяжёлая
возрождение: возрождения
новосибирск: новосибирск
очерковый: очерков
вечёрка: вечёрки
кабалевский: кабалевской
учреждение: учреждений
переложение: переложение
косноязычный: косноязычными
хусаин: хусаинов
музей: музее
необходимость: необходимость
гуманитарный: гуманитарных
маркер: маркером
понравиться: понравилась
xopcт: xopcт
творчество: творчестве
примеч: примеч
пот: пота
уделяться: уделяется
автомобиль: автомобиль
боец: бойцов
застолье: застолий
приехать: приехал
информация: информации
дядька: дядьку
виновный: виновных
лесной: лесных
очередь: очередь
кривцов: кривцова
сопоставимый: сопоставима
исходный: исходная
наслать: нашли
нести: несет
политбюро: политбюро
лв: лв
vladimirakinin: vladimirakinin
pdf-files: pdf-files
агрессия: агрессии
никита: никиты
москва•: москва•
означать: означает
извлекать: извлекает
перипетия: перипетии
технический: технических
аккуратно: аккуратно
перформативный: перформативные
болото: болото
разграбить: разграбили
стихийный: стихийное
соединяться: соединяйтесь
журналистка-политолог: журналистки-политологи
словосочетание: словосочетание
заметить: заметить
экономия: экономии
гугл: гугл
возникать: возникает
восточный: восточной
включительно: включительно
простор: просторах
сто: сто
белые: белые
напряжение: напряжении
минерал: минералов
издаваться: издается
установление: установление
са: са
по-прежнему: по-прежнему
rода: rоды
потом: потом
кодировать: кодировал
здание: здание
выясниться: выяснилось
отчаяние: отчаяния
слушатель: слушателей
пентагон: пентагон
кокусать: кокусай
„: „
посвящаться: посвящается
ресторан-то: ресторан-то
бабушка: бабушке
необходимо: необходимо
мероприятие: мероприятий
обязательно: обязательно
неважно: неважно
авбузуев: авбузуев
ностальгия: ностальгии
справочный: справочным
слон: слонов
комиссар: комиссара
-: -
прикладной: прикладную
подразумевать: подразумевает
математика: математики
довольно: довольно
игнорирование: игнорирование
палата: палаты
любопытно: любопытно
адепт: адепты
плодотворный: плодотворный
специалиста-историк: специалистам-историкам
шеврие: шеврие
некий: некоего
гулять: гуляет
максим: максима
иран: иране
отрицать: отрицает
тонуть: тонешь
съезд: съездом
трындить: трындят
фигурировать: фигурировал
несправедливость: несправедливость
проверка: проверка
добрый: добрые
накануне: накануне
воспоминание: воспоминания
буквально: буквально
немного: немного
публика: публике
целиком: целиком
кат: катом
photo: photo
ненависть: ненависти
соображение: соображений
развалить: развалят
депутат: депутат
прыгать: прыгают
пломбир: пломбир
двигатель: двигатель
поручение: поручению
прекрасный: прекрасной
данциг: данциг
губерния: губернии
идв: идв
препарат: препаратов
обложка: обложки
телёнок: телят
близкий: ближайшие
this: this
джунгли: джунглям
планирование: планирования
толком: толком
опрос: опросов
независимость: независимость
лечь: легли
проект: проект проекта
разработать: разработаны
ден: деном
дипломат: дипломат
бузуев: бузуев
наум: наум
оао: оао
феномен: феномену
ви: ви
ип-шник: ип-шник
тонна: тонна
данные: данных
упорядочение: упорядочение
питание: питания
апатрид: апатрида
техникум: техникумов
холквист: холквист
экоцид: экоцид
целый: целая
историческо-юридический: историческо-юридический
корпорация: корпорации
особенный: особенный
попасться: попалась
задание: задание
намекать: намекает
идентичность: идентичность
нигде: нигде
извне: извне
возложить: возложенной
монолитный: монолитной
айса: айс
продавец: продавцы
опекать: опекающими
